#Criteria: (Average log2fc)*(diff % express) & significant & positive & not ribosomal & top 10 per cluster.
HSD11B1	PericentralHep
APOM	PericentralHep
PON3	PericentralHep
TTC36	PericentralHep
APOC2	PericentralHep
APOC4	PericentralHep
HAMP	PericentralHep
BCHE	PericentralHep
G6PC	PericentralHep
F10	PericentralHep
BCHE	PericentralHep
ALDH6A1	PericentralHep
LINC00261	PericentralHep
G6PC	PericentralHep
AR	PericentralHep
LST1	InfMacrophage
SCD	PeriportalHep
HMGCS1	PeriportalHep
TM7SF2	PeriportalHep
CP	PeriportalHep
CRP	PeriportalHep
MSMO1	PeriportalHep
TMEM97	PeriportalHep
ACAT2	PeriportalHep
ACSS2	PeriportalHep
CYP2A7	PeriportalHep
CYP2A6	PeriportalHep
IGFBP2	PeriportalHep
ENTPD5	PeriportalHep
CFHR1	PeriportalHep
CREB3L3	PeriportalHep
SLC7A2	PeriportalHep
CYP4F2	PeriportalHep
CFB	PeriportalHep
GPX2	PeriportalHep
GSTA1	InterzonalHep
AKR1C1	InterzonalHep
PTGR1	InterzonalHep
SAA4	InterzonalHep
ADH4	InterzonalHep
GNMT	InterzonalHep
TAT-AS1	InterzonalHep
ANG	InterzonalHep
HPD	InterzonalHep
CYB5A	InterzonalHep
PCK1	UnkHep
CPS1	UnkHep
ITIH1	UnkHep
ERRFI1	UnkHep
XIST	UnkHep
SORD	UnkHep
ADH1B	UnkHep
PLG	UnkHep
PHOB	UnkHep
MLXIPL	UnkHep
JCHAIN	AntibodyBcell
MZB1	AntibodyBcell
IGKC	AntibodyBcell
IGHG1	AntibodyBcell
IGLC2	AntibodyBcell
IGHA1	AntibodyBcell
IGHG3	AntibodyBcell
IGHM	AntibodyBcell
IGHG2	AntibodyBcell
IGLC3	AntibodyBcell
CD79B	MatureBcell
CD37	MatureBcell
LTB	MatureBcell
MS4A1	MatureBcell
CD52	MatureBcell
HLA-DQB1	MatureBcell
LINC00926	MatureBcell
HLA-DRA	MatureBcell
IGHD	MatureBcell
TNFRS13C	MatureBcell
FXYD2	Cholangiocyte
KRT7	Cholangiocyte
CD24	Cholangiocyte
DEFB1	Cholangiocyte
SPP1	Cholangiocyte
LCN2	Cholangiocyte
PIGR	Cholangiocyte
ELF3	Cholangiocyte
TACSTD2	Cholangiocyte
CD7	NKlike
KLRB1	NKlike
CMC1	NKlike
XCL2	NKlike
KLRF1	NKlike
KLRC1	NKlike
IL2RB	NKlike
XCL1	NKlike
CD160	NKlike
GNLY	gdTcells
GZMB	gdTcells
FGFBP2	gdTcells
NKG7	gdTcells
PRF1	gdTcells
KLRD1	gdTcells
CST7	gdTcells
HOPX	gdTcells
KLRF1	gdTcells
GZMA	gdTcells
STMN1	gdTcellsProlif
HMGB2	gdTcellsProlif
TYMS	gdTcellsProlif
KIAA0101	gdTcellsProlif
MKI67	gdTcellsProlif
UBE2C	gdTcellsProlif
TOP2A	gdTcellsProlif
TUBA1B	gdTcellsProlif
BIRC5	gdTcellsProlif
NUSAP1	gdTcellsProlif
CD3D	CD3+abTcells
CCL5	CD3+abTcells
TRAC	CD3+abTcells
CD2	CD3+abTcells
CD3E	CD3+abTcells
GZMA	CD3+abTcells
IL32	CD3+abTcells
TRBC2	CD3+abTcells
GZMK	CD3+abTcells
CD69	CD3+abTcells
CD5L	NonMacrophage
MARCO	NonMacrophage
CD163	NonMacrophage
MS4A7	NonMacrophage
C1QB	NonMacrophage
C1QA	NonMacrophage
VSIG4	NonMacrophage
AIF1	NonMacrophage
LIPA	NonMacrophage
VCAM1	NonMacrophage
LYZ	InfMacrophage
S100A9	InfMacrophage
S100A8	InfMacrophage
HLA-DRA	InfMacrophage
TYROBP	InfMacrophage
S100A6	InfMacrophage
MNDA	InfMacrophage
HLA-DPB1	InfMacrophage
FCER1G	InfMacrophage
VCAN	InfMacrophage
MGP	PeriportalLSECs
SPARCL1	PeriportalLSECs
TM4SF1	PeriportalLSECs
CLEC14A	PeriportalLSECs
IGFBP7	PeriportalLSECs
ID1	PeriportalLSECs
ADIRF	PeriportalLSECs
CD9	PeriportalLSECs
VWF	PeriportalLSECs
ID3	PeriportalLSECs
CCL14	cvLSECs
CLEC1B	cvLSECs
FCN2	cvLSECs
FCN3	cvLSECs
CRHBP	cvLSECs
CLEC4G	cvLSECs
STAB1	cvLSECs
GNG11	cvLSECs
OIT3	cvLSECs
CLDN5	cvLSECs
PRSS23	PortEndo
INMT	PortEndo
LIFR	PortEndo
DNASE1L	PortEndo
TAGLN	PortEndo
RAMP3	PortEndo
C7	PortEndo
CTGF	PortEndo
ENG	PortEndo
HSPG2	PortEndo
TAGLN	Stellate
ACTA2	Stellate
COL1A1	Stellate
DCN	Stellate
COL1A2	Stellate
MYL9	Stellate
COL3A1	Stellate
BGN	Stellate
TPM2	Stellate
IGFBP7	Stellate
HBD	Erthyroid
HBA1	Erthyroid
HBA2	Erthyroid
AHSP	Erthyroid
HBM	Erthyroid
ALAS2	Erthyroid
CA1	Erthyroid
HBB	Erthyroid
SLC25A3	Erthyroid
SNCA	Erthyroid
